x,x,1,1,1,1,x,x
x,3,3,3,3,3,3,x
4,4,4,4,4,4,4,4
x,5,5,5,5,5,5,x
x,x,6,6,6,6,x,x
